#ODT  ranHex
AAACGATA	CATGATCA
AAAAAAAAA	CTAAGGGA
ACTCGTAA	CTGCTTTG
TTACCTCG	GGGTAGCG
GCCTGCAA	CCGAGAAA
TGGTATAC	ACGGACTC
CGTTCGAG	ACTTACGA
TCTATTAC	TATTTAAG
ATAAGCTC	ACCGTACG
ATTCATGG	TATAGTCG
ATCCGCGA	TGGGCATC
ATCGCATA	TACCTAGA
CCGTTCTA	GCTGCATG
TGGCGCGC	GTCATATG
TGTCTGAA	ATATTGGC
AATTTCTC	TCGTTTCG
CGCGACTA	GAATAATG
TGAAGCAA	ACTGCGCA
TTATTCTG	GCTTATAG
GTTCAACA	ATCATGCA
ACGCCGGC	ACGTTAAC
TTGTCTTA	CCATCTTG
TACGGTTA	CATAGCTA
TTGGGAGA	GAGGTTGA
TGCTTGGG	GCACTGAC
TAAATATC	TTCATCGC
CACAATTG	GAAATTAG
GTGCTAGC	AGGATTAA
CGCCCGGA	AATAGAAC
GCTCGCGG	TCTTAATC
CTTTGGTC	TAATACGC
TTCCGATC	GTTTGTGA
TTCGCTAC	CGAACGTC
AGCGAAAC	GGTTCTTC
AAATAGCA	GCAAATTC
CGTCTAGG	GCTATGCG
GCCGTGTA	CTACCCTA
CGCTTAAA	GTGGGTTC
GACCTTTC	GTCCGTAG
GGTGGAGC	TGCGATCG
TACTCGAA	TATCCGGG
CATTTGGA	AGGTAATA
GAGCACAA	CGTGGTTG
GTCGCGCG	GACAAAGC
GTTACGTA	GGGCGATG
CTATTTCA	ATCTATAA
ACTATATA	GCCCATGA
AAAAAAAA	CATGAACA
